Comment[ArrayExpressAccession]	E-MTAB-1601
MAGE-TAB Version	1.1																											
Investigation Title	Arabidopsis seedling treated with BA and Zeatin																											
Comment[Submitted Name]	Arabidopsis seedling treated with BA and Zeatin
Experiment Description	Aim was to look at the gene profile changes in 10 days old Arabidopsis seedlings grown in light and treated with either Zeatin or BA and compared to non-treatment																											
Experimental Design	compound_treatment_design	in_vitro_design	co-expression_design																									
Comment[AEExperimentType]	transcription profiling by array																											
Comment[AEExperimentDisplayName]	Transcription profiling by array of Arabidopsis seedlings grown in light with or without benzyladenine or Zeatin treatment																											
Experimental Factor Name	compound	dose																										
Experimental Factor Type	compound	dose																										
Quality Control Type	technical replicates																											
Quality Control Term Source REF	EFO																											
Public Release Date	2013-03-28																											
Person Last Name	Bhargava	Kieber																										
Person First Name	Apurva	Joseph																										
Person Mid Initials																												
Person Email	apurv@ad.unc.edu	jkieber@unc.edu																										
Person Phone																												
Person Address	Office 4144 Genome Sciences Building, UNC Department of Biology, Coker Hall, CB #3280, 120 South Road, Chapel Hill, NC 27599-3280	Office 4163 Genome Sciences Building, UNC Department of Biology, Coker Hall, CB #3280, 120 South Road, Chapel Hill, NC 27599-3280																										
Person Affiliation	University of North Carolina at Chapel Hill	University of North Carolina at Chapel Hill																										
Person Roles	submitter	principal investigator																										
PubMed ID	23524861																											
Publication Author List	Apurva Bhargava, Ivory Clabaugh, Jenn P. To, Bridey B. Maxwell, Yi-Hsuan Chiang, G. Eric Schaller, Ann Loraine and Joseph J Kieber																											
Publication Title	Identification of Cytokinin Responsive Genes Using Microarray Meta-analysis and RNA-seq in Arabidopsis thaliana																											
Publication Status	published																											
Protocol Name	P-MTAB-32096	P-MTAB-32097	P-MTAB-32098
Protocol Type	growth protocol	treatment protocol	nucleic acid extraction protocol																									
Protocol Description	Arabidopsis thaliana seedlings grown on MS media for 10 days in continious light	Treated with either DMSO (control), BA (1 µM) or Zeatin (1 µM)for 120 minutes immersed in liquid MS media on continious shaker  	Using qiagen Plant extractation kit as per manufacturer's instructions																									
Protocol Term Source REF	EFO	EFO	EFO																									
Term Source Name	EFO	ArrayExpress
Term Source File	http://www.ebi.ac.uk/efo	http://www.ebi.ac.uk/arrayexpress																										
SDRF File	E-MTAB-1601.sdrf.txt
