Comment[ArrayExpressAccession]	E-GEOD-53839
MAGE-TAB Version	1.1										
Public Release Date	2014-07-16
Investigation Title	Expression data from 35S:miR396b plants										
Comment[Submitted Name]	Expression data from 35S:miR396b plants
Experiment Description	Transcript profile of  apices of 20 days-old Arabidopsis plants over expressing miR396b. We used ATH1 Affymetrics microarrays to obtain the transcription profile of plants overexpressing miR396b. We compared the transcriptome of 35S:miR396b plants vs wild-type plants (Col-0 accession), using ATH1 Affymetrics microarrays. For these experiments we collected vegetative apices together with the leaf primordia from plants of 20 days growth in short-day. For each genotype (Col-0, 35S:miR396b)  we collected two samples.										
Term Source Name	ArrayExpress	EFO
Term Source File	http://www.ebi.ac.uk/arrayexpress/	http://www.ebi.ac.uk/efo/efo.owl									
Person Last Name	Debernardi	Debernardi	Palatnik								
Person First Name	Juan	Juan	Javier								
Person Mid Initials	Manuel	M	F								
Person Email	debernardi@ibr-conicet.gov.ar										
Person Affiliation	IBR										
Person Address	IBR, Ocampo y Esmeralda, Rosario, Santa Fe, Argentina										
Person Roles	submitter										
Protocol Name	P-GSE53839-1	P-GSE53839-2	P-GSE53839-9	P-GSE53839-6	P-GSE53839-10	P-GSE53839-7	P-GSE53839-3	P-GSE53839-4	P-GSE53839-5	P-GSE53839-11	P-GSE53839-8
Protocol Description	The data were analyzed with Robina software (version_1.2.4), analysis strategy: Limma normalization method: gcrma ID_REF =  VALUE = Log2 GC-RMA signal	The data were analyzed with Robina software (version_1.2.4), analysis strategy: Limma normalization, method: gcrma ID_REF =  VALUE = log2 GC-RMA signal	standard Affymetrix protocol	Affymetrix instructions	standard Affymetrix protocol	Affymetrix instructions	Vegetative apices together with the leaf primordia were dissected from plants of 20 days.	Plants were grown on soil medium in short photoperiods (8 h light/16 h dark) at 23 °C.	Total RNA was extracted from dissected vegetative apices using the RNeasy plant mini kit (QIAGEN).	standard Affymetrix protocol	Affymetrix instructions
Protocol Type	normalization data transformation protocol	normalization data transformation protocol	labelling protocol	labelling protocol	hybridization protocol	hybridization protocol	sample treatment protocol	growth protocol	nucleic acid extraction protocol	array scanning protocol	array scanning protocol
Experimental Factor Name	GENOTYPE	ORGANISM PART									
Experimental Factor Type	genotype	organism part									
Comment[SecondaryAccession]	GSE53839										
Comment[GEOReleaseDate]	2014-07-16										
Comment[ArrayExpressSubmissionDate]	2014-01-06										
Comment[GEOLastUpdateDate]	2014-07-17										
Comment[AEExperimentType]	transcription profiling by array										
SDRF File	E-GEOD-53839.sdrf.txt
